........................................
..................x.....................
..............x...x.....................
.............x....x..........c..........
............x..xxxxxxxxxxxxxxxxxxxxxxxxx
...........x............................
..........x.............................
.........x..............................
....c..x............e.........ccc......x
xxxxxxxxxxxxxxxxxxxxxxxxxxxxxxxxxxxxxxxx
