........................................
..................x...hhh...............
..............x...x.....................
.............x..2.x.....e....c.....e....
............x..xxxxxxxxxxxxxxxxxxxxxxxxx
.s.........x............................
..........x.............................
.........x..............................
....c..x......e...ffff........ccc..e...x
xxxxxxxxxxxxxxxxxxxxxxxxxxxxxxxxxxxxxxxx
