........................................
..................x.....................
..............x...x.....................
.............x....x.....e....c..........
............x..xxxxxxxxxxxxxxxxxxxxxxxxx
...........x............................
..........x.............................
.........x..............................
....c..x......c...............ccc..e...x
xxxxxxxxxxxxxxxxxxxxxxxxxxxxxxxxxxxxxxxx
