........................................
..................x.....................
..............x...x.....................
.............x....x.....e....c.....e....
............x..xxxxxxxxxxxxxxxxxxxxxxxxx
.s.........x............................
..........x.............................
.........x..............................
....c..x......e..........2....ccc..e...x
xxxxxxxxxxxxxxxxxxxxxxxxxxxxxxxxxxxxxxxx
