........................................
..................x.....................
..............x...x.....................
.............x....x.....e....c.....e....
............x..xxxxxxxxxxxxxxxxxxxxxxxxx
...........x............................
..........x.............................
.........x..............................
....c..x......e...............ccc..e...x
xxxxxxxxxxxxxxxxxxxxxxxxxxxxxxxxxxxxxxxx
